4lan|Alanderson Meireles
abbedagge|Felix Braun
absolut|Luis Felipe Carvalho
add|Kang Geon-mo (강건모)
adrian|Adrian Ma
aiming|Kim Ha-ram (김하람)
akaadian|Matthew Higginbotham
alexich|Alexey Ichetovkin
alphari|Barney Morris
altec|Johnny Ru
alternativex|João Parada
ambition|Kang Chan-yong (강찬용)
anda|Andy Hoang
anderu|Andrew Baihn
anyyy|Ruan Silva
aphromoo|Zaqueri Black
apollo|Apollo Price
ares|Kim Min-kwon (김민권)
armut|İrfan Berk Tükek
arrow|No Dong-hyeon (노동현)
aslan|Eduardo Nunes
attila|Amadeu Carvalho
ayel|Marcelo Mello
b4dd|Vinícius Marinheiro
babip|Leo Romer
backlund|Jonathan Bäcklund
baiano|Gustavo Gomes
balls|An Le
bang|Bae Jun-sik (배준식)
bdd|Kwak Bo-seong (곽보성)
bdoink|Dmitry Botov
beryl|Cho Geon-hee (조건희)
betsy|Felix Edling
big|Terry Chuong
biofrost|Vincent Wang
biopanther|Brandon Alexander
bjergsen|Søren Bjerg
blaber|Robert Huang
blank|Kang Sun-gu (강선구)
blossom|Park Beom-chan (박범찬)
bono|Kim Gi-beom (김기범)
boxbox|Albert Zheng
brokenblade|Sergen Çelik
broxah|Mads Brock-Pedersen
brtt|Felipe Gonçalves
brucer|Bruno Pereira
bwipo|Gabriël Rau
cabochard|Lucas Simon-Meslet
cabu|Victor Oliveira
caedrel|Marc Robert Lamont
calm|Lee Chae-hwan (이채환)
canyon|Kim Geon-bu (김건부)
caps|Rasmus Winther
carbon|Tim Wendel
cariok|Marcos Oliveira
chaser|Lee Sang-hyun (이상현)
cheongo|Choi Hyeon-woo (최현우)
chippys|Ryan Short
chovy|Jeong Ji-hoon (정지훈)
chuchuz|Aaron Bland
claire|Brandon Nguyen
clid|Kim Tae-min (김태민)
closer|Can Çelik
codysun|Li Yu Sun
corejj|Jo Yong-in (조용인)
cptjack|Kang Hyung-woo (강형우)
crash|Lee Dong-woo (이동우)
crazy|Kim Jae-hee (김재희)
cris|Cristian Rosales
crow|Kim Seon-gyu (김선규)
crown|Lee Min-ho (이민호)
crownshot|Juš Marušič
crush|Kim Jun-seo (김준서)
cuden|Mike Le
cupcake|Andy van der Vyver
cuvee|Lee Seong-jin (이성진)
cuzz|Uchan Mun
ceos|Denilson Oliveira Gonçalves
damage|Yan Sales Neves
damonte|Tanner Damonte
dardoch|Joshua Hartnett
darkside|Alejandro Oyonate
darshan|Darshan Upadhyaya
Decoy|Daniel Ealam
deft|Kim Hyuk-kyu (김혁규)
deftly|Matthew Chen
destiny|Mitchell Shaw
dhokla|Niship Doshi
dioud|Hugo Padioleau
djoko|Charly Guillard
doraon|Kim Do-yeong (김도영)
doublelift|Yiliang Peng
dove|Kim Jae-yeon (김재연)
dream|Ronan Swingler
dreams|Han Min-kook (한민국)
duclou|Francisco Duclou Rito
dudstheboy|Igor Lima
duke|Lee Ho-Seong (이호성)
dumbledoge|Mustafa Kemal Gökseloğlu
dynquedo|Matheus Rossini
dyrus|Marcus Hill
edge|Lee Ho-seong (이호성)
effort|Lee Sang-ho (이상호)
egym|Bryce Paule
ehe|Berk Kocaman
eika|Jérémy Valdenaire
ella|Kwok Na-hoon (곽나훈)
elwind|Kaan Atıcı
envy|Bruno Farias
erssu|Jeon Ik-soo (전익수)
eryon|Márcio Reis
esa|André Pavezi
exileh|Fabian Schubert
fabfabulous|Asım Cihat Karakaya
faker|Lee Sang-hyeok (이상혁)
febiven|Fabian Diepstraten
fenix|Kim Jae-hun
ferchu|Fernando Aoki
fitz|Mateus Cayres
flame|Lee Ho-jong (이호종)
fly|Song Yong-jun (송용준)
fnb|Francisco Natanael Braz do Espirito Santo Miranda
frae|Leon Lee
freeze|Aleš Kněžínek
froggen|Henrik Hansen
frozen|Kim Tae-il (김태일)
fury|Lee Jin-yong (이진용)
gango|Byun Se-hoon (변세훈)
gbm|Lee Chang-seok (이창석)
ghost|Jang Yong-jun (장용준)
gilius|Berk Demir
goku|Bruno Miyaguchi
goldenglue|Greyson Gilmer
gorilla|Kang Beom-hyeon (강범현)
grace|Lee Chan-ju (이찬주)
grig|Jonathan Armao
guger|Kim Do-yeop (김도엽)
hades|Volkan Dinçer
hakuho|Nickolas Surgent
hanssama|Steven Liv
hard|Anthony Barkhovtsev
haru|Kang Min-seung (강민승)
hauntzer|Kevin Yarnell
heaq|Martin Kordmaa
helper|Kwon Young-jae (권영재)
gosu|
hiiva|Aleksi Kaikkonen
hioss|Emircan Hazar
hjarnan|Petter Freyschuss
hoit|Ryu Ho-seong (류호성)
hollow|Shin Yong-jin (신용진)
holyphoenix|Anıl Işık
huhi|Choi Jae-hyun (최재현)
humanoid|Marek Brázda
huni|Seung-Hoon Heo
hustlin|Morgan Granberg
hylissang|Zdravets Galabov
ian|An Jun-hyeong (안준형)
ignar|Dong-Geun Lee
impact|Jung Eon-yeong
innaxe|Nihat Aliev
inori|Rami Charagh
jactroll|Jakub Skurzyński
jankos|Marcin Jankowski
japone|Bahadır Çolak
jayj|Juan Guibert
jayke|Jayke Paulsen
jelly|Son Ho-gyeong (손호경)
jensen|Nicolaj Jensen
jesiz|Jesse Le
jeskla|Jesper Klarin Strömberg
jiizuke|Daniele di Mauro
jockster|Luan Cardoso
joey|Joseph Haslemann
joker|Cho Jae-eup (조재읍)
justice|Yoon Seok-joon (윤석준)
juzinho|Gabriel Nishimura
k1ng|Calvin Truong
kairos|Gürsu Kömürcü
kami|Gabriel Santos
kasing|Raymond Tsang (曾家星)
keane|Lae-Young Jang
keith|Yuri Jew
kellin|Kim Hyeong-gyu (김형규)
key|Kim Han-gi (김한기)
khan|Dongha Kim
kiin|Kim Gi-in (김기인)
kikis|Mateusz Szkudlarek
kirei|Thomas Yuen
kiwikid|Alan Nguyen
klaus|Augusto Clauss
kobbe|Kasper Kobberup
kold|Jonas Andersen
kramer|Ha Jong-hun (하종훈)
krastyel|Marcos Henrique Ferraz
kuro|Lee Seo-haeng (이서행)
kuzan|Lee Seong-hyeok
lamabear|Leon Krüger
lava|Kim Tae-hoon (김태훈)
lechase|António Ramalho
lehends|Son Si-woo (손시우)
leo|Han Gyeo-re (한겨레)
lep|Pedro Marcari
levi|Đỗ Duy Khánh
licorice|Eric Ritchie
life|Kim Jeong-min (김정민)
lindarang|Heo Man-heung (허만흥)
link|Austin Shin
lira|Nam Tae-yoo (남태유)
lod|Benjamin deMunck
loken|Lee Dong-wook (이동욱)
looch|Carlo la Civita
loop|Caio Almeido
lost|Lawrence Hui
loulex|Jean-Victor Burgevin
lourlo|Samson Jackson
luger|Fatih Güven
luskka|Lucas Rentechen
madlife|Hong Min-gi (홍민기)
madness|Gökhan Uçar
magifelix|Felix Boström
malrang|Kim Geun-seung (김근성)
marin|Jang Gyeong-Hwan (장경환)
mata|Cho Se-hyeong
matsukaze|Pedro Gama
matt|Matthew Elento
max|Jeong Jong-bin (정종빈)
maxlore|Nubar Sarafian
memento|Jonas Elmarghichi
meteos|Will Hartman
micao|Micael Rodrigues
mickey|Son Young-min (손영민)
mikeyeung|Michael Yeung
mikyx|Mihael Mehle
milica|Aljoša Kovandžić
mills|Guilherme Uessler Conti
minerva|Gustavo Alves
mithy|Alfonso Aguirre Rodriguez
mlxg|Liu Shi-yu (刘世宇)
moojin|Kim Moo-jin (김무진)
move|Kang Min-su (강민수)
mowgli|Lee Jae-ha (이재하)
mylon|Matheus Baronti
nagne|Sang-Moon Kim
nappon|Carlos Rücker
naru|Koray Bıçak
nemesis|Tim Lipovšek
nisqy|Yasin Dincer
norskeren|Tore Hoel Eilertsen
nova|Park Chan-ho (박찬호)
nuclear|Sin Jeong-hyeon (신정현)
nuguri|Jang Ha-gwon (장하권)
nyu|Renan Augusto Silva
odoamne|Andrei Pascu
olleh|Joo-Sung Kim
onfleek|Kim Jang-gyeom (김장겸)
only|Jordan Middleton
padden|Ege Acar Koparal
panky|Uğur Taş
papryze|Daniel Francis
patrik|Patrik Jírů
pawn|Heo Won-seok
pbo|Pablo Yuri
peanut| Han Wang-ho (한왕호)
perkz|Luka Perković
phaxi|Ambrož Hren
piglet|Chae Gwang-jin
pilot|Na Woo-hyung (나우형)
pilter|Hakan Yüksel
pirean|Choi Jun-sik (최준식)
pobelter|Eugene Park
powerofevil|Tristan Schrage
praedyth|Mark Lewis
praelus|Jordan Fernandes
pray|Kim Jong-in (김종인)
professor|Matheus Leirião
profit|Kim Joon-Hyung
promisq|Hampus Abrahamsson
punch|Son Min-hyuk (손민혁)
quas|Diego Ruiz
ragner|Onurcan Aslan
raid|Julian Skordos
raise|Ji-hwan Oh
rakin|Rafael Knittel
ranger|Filipe Brombilla
rascal|Kim Kwang-hee (김광희)
rather|Shin Hyeong-seop (신형섭)
redbert|Ygor Freitas
rekkles|Martin Larsson
revanche|Hakan İşlek
revenger|Kim Kyu-seok (김규석)
revolta|Gabriel Henud
riyev|Marcelo Carrara
roach|Kim Kang-hee
road|Yun Han-Gil (윤한길)
robo|Leonardo Souza
rogu|Burak Eryol
rogue|Jake Sharwood
rosey|Andrew Rose
ruby|Lee Sol-min (이솔민)
ruin|Kim Hyeong-min (김형민)
ruler|Park Jae-hyuk (박재혁)
ruvelius|Mustafa Berk Baraklı
ry0ma|Tommy Le
ryu|Yoo Sang-ook (유상욱)
sacyr|Gustavo Rossi
samux|Samuel Fernández Fort
sangyoon|Gwon Sang-yun (권상윤
santorin|Lucas Tao Kilmer Larsen
sarkis|Matheus Guimarães
scarlet|Marcel Wiederhofer
score|Go Dong-bin (고동빈)
seb|Sebastian Deceglie
selfie|Marcin Wolski
selfmade|Oskar Boderek
sencux|Chres Laursen
seonghwan|Yoon Seong-hwan (윤성환)
shady|Joran Robison
shiphtur|Danny Le
shok|Ari Greene-Young
showmaker|Heo Su (허수)
shrimp|Lee Byeong-hoon (이병훈)
sirnukesalot|Risto Luuri
sirt|Thúlio Carlos
sky|Kim Ha-neul (김하늘)
skybart|Matheus Neves
smeb|Song Kyung-ho (송경호)
smittyj|Lennart Warkus
smoothie|Andy Ta
sneaky|Zachary Scuderi
snowflower|No Hoi-jong (노회종)
soaz|Paul Boyer
sohwan|Kim Jun-yeong (김준영)
spirit|Lee Da-yoon
spookz|Samuel Broadley
ssol|Jin-sol Seo (서진솔)
ssumday|Kim Chan-ho (김찬호)
ssun|Kim Tae-yang (김태양)
steeelback|Pierre Medjaldi
stefan|Stefan Nikolić
steve|Etienne Michels
stitch|Lee Seung-ju (이승주)
stixxay|Trevor Hayes
stomaged|Furkan Güngör
stunt|William Chen
summit|Park Woo-tae (박우태)
svenskeren|Dennis Johnsen
swathe|Ryan Gibbons
sword|Choi Sung-won (최성원)
swordart|Hu Shuo-Chieh (胡碩傑)
sybol|Lachlan Civil
takeshi|Murilo Alves
tally|James Shute
tana|Lee Sang-wook (이상욱)
targamas|Raphaël Crabbé
tarzan|Lee Seung-yong (이승용)
tay|Rodrigo Panisa
teddy|Park Jin-seong
tempt|Kang Myung-gu (강명구)
thal|Park Kwon-hyuk (박권혁)
thaldrin|Berke Demir
theusma|Matheus Lima
tilting|Isaac Bellamy
tinowns|Thiago Sartori
titan|Alexandre Lima
tockers|Gabriel Claumann
tolerant|Barış Çepnioğlu
totoro|Eun Jong-seop (은종섭)
trace|Yeo Chang-dong (여창동)
trick|Kim Gang-yun (김강윤)
trick2g|Tim Foley
trix|Mehmet Furkan Çoruk
turtle|Gabriel Peixoto
tusin|Bak Jong-ik (박종익)
umti|Eom Seong-hyeon
untara|Park Ui-jin
upset|Elias Lipp
uzi|Jian Zi-Hao (简自豪)
v1per|Omran Shoura
valkrin|Richard Royer 
value|Ross Luppino
vander|Oskar Bogdan
vash|Guilherme Del Buono
verfix|Jorge Silveira
vert|Alvaro Miguel Martins
viper|Park Do-hyeon (박도현)
vizicsacsi|Kiss Tamás
vulcan|Philippe Laflamme
wadid|Bae-In Kim
werlyb|Jorge Casanovas
whiteknight|Matti Sormunen
wickd|Mike Petersen
wiggily|Raymond Griffin
wildturtle|Jason Tran
wingsofdeath|Daryl Hennegan
wizer|Choi Ui-seok (최의석)
wolf|Lee Jae-wan (이재완)
wos|Willyam Bonpam
wunder|Martin Hansen
xerxe|Andrei Dragomir
xico|Francisco Cruz Antunes
xmithie|Jake Puchero
xpecial|Alex chu
xpeke|Enrique Cedeño Martínez
yampi|Yan Petermann
yang|Felipe Zhao
yellowstar|Bora Kim
yoda|Felipe Noronha
yuuki|Florent Soler
zantins|Lucas Zanqueta
zeitnot|Berkay Aşıkuzun
zergsting|Onur Ünalan
zet|Hae Sung-min (해성민)
zeyzal|Tristan Stidam
zig|Derek Shao
ziriguidun|Pedro Vilarinho
zuao|João Vitor Morais
zven|Jesper Svenningsen
zzus|Jang Joon-soo (장준수)
